Humans: 200
RRRRRRRRRRRRRRRRRRRRRRRRRRRRRRRRRRRRRRRRRRRRRRRRRRRRRRRRRRRRRRRRRRRRRRRRRRRRRRRRRRRRRRRRRRRRRRRRRRRRRRRRRRRRRRRR
R..............................................................................................................R
R.@............................................................................................................R
R..............................................................................................................R
R...........................................Z..................................................................R
R...........RRRGRGRRR.....RRRRRGGRRRRR.................LGGLBBBBLGGLBBBBLGGL....................................R
R...........R.......R.....G..........L.................L....B........B....L........BBBGBBGBBGBB.BBGBBGBBGBBB...R
R...........R.......L.....L............................G....B........B....G........B......B.........B......B...R
R...........R........................L.................B....B........B....B........BBBBBB.............BBBBBB...R
R.....Z.....R.......L.....L.....RRRRRR.............Z........B........B.............L.......................L...R
R...........RRRGRGRRR.....G..........R.................B....BBBL..LBBB....B....................................R
R.........................RRRRRGGRRRRR.................G..................G....................................R
R......................................................L..................L........L.......................L...R
R......................................................LGGLBBBBL..LBBBBLGGL........B.......................B...R
R.....................................Z............................................B.......................B...R
R..................................................................................BBBGBBGBBGBB.BBGBBGBBGBBB...R
R.........................................................................Z....................................R
R................................................................BBGGBL..LBGGBB................................R
R..........LLLLLGGGLLLLLLLLLLLLGGGLLLLL......BGBBGB..............B............B................................R
R..........L.............L............L......B....B..............B............B................................R
R..........G.............L............G......B....G.........Z....L............L................................R
R..........LLLLLLL.LLLLLLLLLLLLL.LLLLLL...........G...............................Z............................R
R..Z.........................................B....B..............L............L................................R
R............................................BGBBGB..............B............B......................Z.........R
R..........LLLL.LLLLLLLLL.LLLLLLLL.LLLL..........................B............B............LLB.BLL.............R
R..........G.......L..........L.......G..........................BBGGBL..LBGGBB............B.....B.............R
R..........L.......L..........L.......L..........................................................B.............R
R..........LLLL.LLLLLLLLL.LLLLLLLL.LLLL......RRR.RRR.......................................B...................R
R............................................R.....R...................Z...................B.....B.............R
R..........................................................................................LLGGGLL.........Z...R
R............................................R.....R...........................................................R
RRRRRRRRRRRRRRRRRRRRRRRRRRRRRRRRRRRRRRRRRRRRRRRRRRRRRRRRRRRRRRRRRRRRRRRRRRRRRRRRRRRRRRRRRRRRRRRRRRRRRRRRRRRRRRRR